!1 for far background, 2 for midground.
0     2         1       2       1       0
0          1        1        1          0
0     1         2       2     2   1     0
0  2      2         2       1           0
0       2     1        1         2      0
0  1              2      2          2   0
0    2   1       1     2        1       0
0  1        2            1   2          0
0     21         2 2              1     0
0  2       2      1     1       2       0
0     1        2        1        1      0
000000000000          0000000000000000000