! 1 is ground tile, 0 is nothing.
!
1
1
1
1                                     111
1          111                    11
1     111               11  1111
1 11      111    11  11
1     111               11
1   1
1  1         111           1111
11               1111
111111111111          1111111111111111111