! 1 is ground tile, 0 is nothing.
!
1                                           0
1                                           0
1                                           0
1                                           0
1                                           0
1                                           0
1                                           0
1                                           0
1                1111           111  1  1 1 0
1      11 1  11             11              0
1   11                   11                 0
1 1                                         0
111111111111111111111111111111111111111111111